111111111111111111
1P01C000100C000E01
100000000001000101
10C010C000C0000001
101000100010C01001
111111111111111111